14 15
###############
#      +      #
#  ^       ** #
#####  s  #####
# +     e     #
#   %         #
#**        F  #
#F    *       #
### ^       ###
# D     e   D #
###  $      ###
#  *         ^#
#  ^          #
###############