14 15
###############
#***********F*#
#  ^  +     s #
##########D####
#       e    s#
#   %         #
#          F  #
#  s          #
###           #
#*D           #
###  $        #
#*********^***#
#****^********#
###############